11111111
10001C11
10101C01
1P1000E1
11111111